0000000000000000
0000000200000000
0000000200120000
0000000000100000
0000000000111111
0000020000120000
0000020000100000
0000000000020011
0000000000000010