0000200010000000
0000222210000000
1111111111111111
0000000012000000
0000000011111111
0000000022200000
1111111111111111
0022100000000000
0002100000000000